10 20
|-----------------|
|.................|
|.....@...........|
|.................|
|.................|
|.............F...|
|.................|
|.........G.......|
|.................|
|-----------------|